W,W,W,W,W,W,W,W,W,W,W,W,W,W,W,W,W,W,W,W,W,W,W,W,W,W,W,W,W
W,O,O,O,O,O,O,O,O,O,O,O,O,O,W,O,O,O,O,O,O,O,O,O,O,O,O,O,W
W,O,O,O,O,O,O,O,O,O,O,O,O,O,W,O,O,O,O,O,O,O,O,O,O,O,O,O,W
W,O,O,W,W,W,O,O,W,W,W,W,O,O,W,O,O,W,W,W,W,O,O,W,W,W,O,O,W
W,O,O,W,W,W,O,O,W,W,W,W,O,O,W,O,O,W,W,W,W,O,O,W,W,W,O,O,W
W,O,O,O,O,O,O,O,O,O,O,O,O,O,O,O,O,O,O,O,O,O,O,O,O,O,O,O,W
W,O,O,O,O,O,O,O,O,O,O,O,O,O,O,O,O,O,O,O,O,O,O,O,O,O,O,O,W
W,O,O,W,W,W,O,O,W,O,O,W,W,W,W,W,W,W,O,O,W,O,O,W,W,W,O,O,W
W,O,O,O,O,O,O,O,W,O,O,O,O,O,W,O,O,O,O,O,W,O,O,O,O,O,O,O,W
W,O,O,O,O,O,O,O,W,O,O,O,O,O,W,O,O,O,O,O,W,O,O,O,O,O,O,O,W
W,W,W,W,W,W,O,O,W,W,W,W,O,O,W,O,O,W,W,W,W,O,O,W,W,W,W,W,W
I,I,I,I,I,W,O,O,W,O,O,O,O,O,O,O,O,O,O,O,W,O,O,W,I,I,I,I,I
I,I,I,I,I,W,O,O,W,O,O,O,O,O,O,O,O,O,O,O,W,O,O,W,I,I,I,I,I
W,W,W,W,W,W,O,O,W,O,O,W,W,W,W,W,W,W,O,O,W,O,O,W,W,W,W,W,W
I,O,O,O,O,O,O,O,O,O,O,W,I,I,I,I,I,W,O,O,O,O,O,O,O,O,O,O,I
I,O,O,O,O,O,O,O,O,O,O,W,I,I,I,I,I,W,O,O,O,O,O,O,O,O,O,O,I
W,W,W,W,W,W,O,O,W,O,O,W,W,W,W,W,W,W,O,O,W,O,O,W,W,W,W,W,W
I,I,I,I,I,W,O,O,W,O,O,O,O,O,O,O,O,O,O,O,W,O,O,W,I,I,I,I,I
I,I,I,I,I,W,O,O,W,O,O,O,O,O,O,O,O,O,O,O,W,O,O,W,I,I,I,I,I
W,W,W,W,W,W,O,O,W,O,O,W,W,W,W,W,W,W,O,O,W,O,O,W,W,W,W,W,W
W,O,O,O,O,O,O,O,O,O,O,O,O,O,W,O,O,O,O,O,O,O,O,O,O,O,O,O,W
W,O,O,O,O,O,O,O,O,O,O,O,O,O,W,O,O,O,O,O,O,O,O,O,O,O,O,O,W
W,O,O,W,W,W,O,O,W,W,W,W,O,O,W,O,O,W,W,W,W,O,O,W,W,W,O,O,W
W,O,O,O,O,W,O,O,O,O,O,O,O,O,O,O,O,O,O,O,O,O,O,W,O,O,O,O,W
W,O,O,O,O,W,O,O,O,O,O,O,O,O,O,O,O,O,O,O,O,O,O,W,O,O,O,O,W
W,W,W,O,O,W,O,O,W,O,O,W,W,W,W,W,W,W,O,O,W,O,O,W,O,O,W,W,W
W,O,O,O,O,O,O,O,W,O,O,O,O,O,W,O,O,O,O,O,W,O,O,O,O,O,O,O,W
W,O,O,O,O,O,O,O,W,O,O,O,O,O,W,O,O,O,O,O,W,O,O,O,O,O,O,O,W
W,O,O,W,W,W,W,W,W,W,W,W,O,O,W,O,O,W,W,W,W,W,W,W,W,W,O,O,W
W,O,O,O,O,O,O,O,O,O,O,O,O,O,O,O,O,O,O,O,O,O,O,O,O,O,O,O,W
W,O,O,O,O,O,O,O,O,O,O,O,O,O,O,O,O,O,O,O,O,O,O,O,O,O,O,O,W
W,W,W,W,W,W,W,W,W,W,W,W,W,W,W,W,W,W,W,W,W,W,W,W,W,W,W,W,W
